{
  "floors": [
    {
      "floor_number": 1,
      "title": "지하 1층: 문자의 무덤",
      "rooms": [
        {
          "room_id": "1-1",
          "title": "빛",
          "grid": [
            ["#", "#", "#", "G", "#", "#", "#"],
            ["#", " ", " ", " ", " ", " ", "#"],
            ["#", "i", " ", "_", " ", "i", "#"],
            ["#", " ", " ", "I", " ", " ", "#"],
            ["#", " ", " ", " ", " ", " ", "#"],
            ["#", " ", " ", " ", " ", " ", "#"],
            ["#", "#", "#", "S", "#", "#", "#"]
          ]
        },
        {
          "room_id": "1-2",
          "title": "불",
          "grid": [
            ["#", "#", "#", "#", "#", "#", "#"],
            ["#", " ", " ", " ", "i", "i", "#"],
            ["#", " ", " ", " ", " ", " ", "#"],
            ["G", " ", " ", "_", " ", " ", "#"],
            ["#", " ", " ", "I", " ", " ", "#"],
            ["#", " ", " ", " ", " ", " ", "#"],
            ["#", " ", " ", " ", " ", " ", "#"],
            ["#", "#", "#", "S", "#", "#", "#"]
          ]
        }
      ]
    }
  ]
}